Abbasov	Ramiz	3
Abdessamie	Belhocine	2
Abdulaliyev	Murad	5
Abdullayev	Nazim	5
Aboelfetoh	Mohamed	3
Adebomehin	Abdulraheem	3
Adebomehin	Abdulrahman	5
Ahmed	Mohamed	4
Ahyod	Youness	3
Aitanov	Ariet	3
Akmataliev	Azhymukan	2
Akylbek	Madumar	4
Alakbarov	Jasarat	2
Alikhanov	Elmar   3
Aliyev	Abasgulu	4
Alizade	Khatai  2
Alloula	Achraf	4
Artikgaliev	Farokhitdin	3
Asanov	Sadyk	5
Avazbekov	Tilek	5
Avazbekova	Aimira	2
Avliyakulyyev	Ylham	2
Azimov	Feruzbek	5
Babakhanyan	Zhora	2
Babanli	Elvin	5
Babayev	Farhad	5
Babirov	Murad	3
Bekiev	Adilet	2
Beksultanova	Kanykei	5
Belgout	Mohamed	3
Benayad	Karima	5
Bvirakare	Tadiwanashe	5
Chasi	Mitchelle	3
Chipunza	Archbauld	4
Daha	Abdellah	3
Denga	Nichole	3
Desta	Bereket	2
Dimosi	Arshed	4
Dube	Graciano	4
Duwa	Darlington	2
Dzingira	Carlton	3
El Alami	Zakaria	2
Espin Novillo	Sebastian	4
Fikreselassie	Bezawit	4
Fuzaylov	Normukhammad	3
Gamil	Abdelaziz	5
Garikai	Tinotenda	5
G�nen	Beyza	3
Guettaf	Yousra	3
Haspadaryk	Dzmitry	2
Hassanein	Ahmed	5
Hassoune	Yahia	3
Hinda	Anesu	5
Ibrahim	Ibrahim	2
Ineza	Jean	2
Irias Hernandez	Oscar	2
Jafarov	Nihat	2
Johnny	Kudzai	3
Junior	Stewart	5
Kabade	Ioi	5
Kamamba	Takudzwa	4
Kambarbekov	Amantur	3
Kandarira	Tadiwanashe	5
Karabaev	Alisher	5
Karaevi	Kamran	3
Kardic	Hamit	2
Karimov	Nail	5
Karymshakov	Bekzhan	4
Kazuva	Malcom	4
Khanday	Wasif	3
Kozak	Akram	3
Kubwimana	Lilly	3
Maenzanise	Tadiwanashe	4
Mahairi	Laith	2
Malangisha	Musonda	2
Mandibaya	Chrispen	5
Manzi	Daniel	3
Maratov	Alisher	2
Marikopo	Maureen	4
Moataz	Mohamed	5
Moussaid	Anouar	3
Moyana	Natalie	5
Mugagami	Lenin	3
Munzara	Tanaka	2
Muradzi	Tinotenda	5
Muratov	Timurlan	2
Murzaliev	Alikhan	4
Nazirov	Ariz	3
Niyazov	Daulet	3
Nuray	�mer	4
Nyandoro	Nyasha	2
Rakhmikhudoev	Tamriz	3
Rodrigo	Edson	5
Ruwizhi	Tatenda	5
Rybchinsky	Ignat	2
Sag?r	Ahmet	4
Serghine	Imad	4
Simbarashe	Ryan	3
Smirnov	Nikita	3
Sovkhozov	Alban	3
Turan	Alperen	2
Umuhoza	Axcella	2
Umukundwa	Ornella	2
Yakavenka	Fiodar	5
Yavuz	Habibe	2
Youssef	Sherif	4
Zayidova	Reyhan	3
Zhumanaliev	Daler	5
